%%%%%%%%%%%%%%%%%%%%%%%%%%%%%%%%%%%%%
%       % % %     ^     %   %  ~  % %
% %%%%%%% % %%% % %%% %%% %%%%%%% % %
%   ~   %   ~   % %  ^  %     % %   %
%%%%% %%%%% %%% % % % %%% %%%%% % %%%
%   % % % %   % % % %   % %   % % ^ %
% %%% % % % %%% %%%%% %%% % %%% %%% %
%   ~   %  ^  %   %   %  ~  % % %   %
%%% %%%%%%%%% %%%%%%% %%% %%% % % % %
%      ^      %       % %   %  ~  % %
% % %%%%% % %%% % % %%% % %%% %%% % %
% % %     % % % % %  ~  %   % % % % %
% % % %%%%%%% % %%%%%%%%% %%% % %%% %
% % % %  ~  %   %  ^  %     %   %   %
%%% %%% % %%%%% %%%%% %%% %%% %%%%% %
%     % % %  ~  % %  ^  % %   % % % %
% % % % % %%% %%% %%% %%% % % % % % %
% % % % %    ^^     ~  % % %     %  %
%%% %%%%%%% % % %%%%% %%% % %%% %%%%%
%       % % % %  ~  %   %  ^  % %   %
%%%%% % % %%%%%%%%% %%%%%%%%%%% % %%%
%   % %    ~    % %  ^  %   % %   % %
% %%% %%%%% %%%%%%%%% %%%%% % % %%% %
% %   %   ^  %        %     %  ~    %
% % % %%%%% %%% % % % % %%%%%%%%%%%%%
% % %   %     % % % %       %   % % %
% % %%% %%% % % % %%%%%%%%% %%% % % %
% %   % %   % % %   % %   % % %  ^  %
% %%% %%% %%%%% %%% % % %%%%% % %%%%%
%       %   %  ~  % %     %   % %   %
%%% % %%%%% %%%%% %%% %%% % %%% % %%%
% % % % % % % %     % %   % %   % % %
% % %%% % % % % %%%%%%%%% % % % % % %
%   %   %   %    ~^~          %     %
% % % % %%% %%% %%%%%%% %%% %%% %%% %
%S% % %       %   %       %   % %  R%
%%%%%%%%%%%%%%%%%%%%%%%%%%%%%%%%%%%%%
