%%%%%%%%%%%%%%%%%%%%%%
% %%   ^   % %   ~   %
%    %%%%%% % %%%%%% %
%%%%%%     R  %   ^  %
%    % %%%%%% %% %%%%%
% %%%% %   ~     %   %
%   ^    %%% %%%   % %
% %%%%%%%%    %%%%%% %
%S    ^    %   ~     %
%%%%%%%%%%%%%%%%%%%%%%
