%%%%%%%%%%%%%%%%%%%%%%%%%%%%%%%%%%%%
%                                 R%
% %%%%%%%%%%%%%%%%%%%%%%% %%%%%%%% %
%^%%   %   %   ^  %%%%%%%   %%  ~  %
% %% % % % % %%%% %%%%%%%%% %% %%%%%
%^%% % % % %   ~  %%     %% %%  ^  %
% %% % % % % % %%%%  %%%    %%%%%% %
%^%  % % %   %   ^  % %%%%%%%%  ~  %
% %% % % %%%%%%%% %%   ^    %% %%%%%
%^%% %   %%  ~   ^%%%%%%%% %%  ^   %
%    % %%%% %%%%%%%  ~   %% %%%%%% %
%%%%%%   ^  %      %%%% %% %   ~   %
%      %%%%%% %%%%% %    %% %% %%%%%
% %%%%%%      %  ^    %%%%% %%     %
%        %%%%%% %%%%%%%%%%% %%  %% %
% %%%%%%%%     ~^~          %%%%%% %
%S         %%%%%%%%%%%%%%%  ~^~    %
%%%%%%%%%%%%%%%%%%%%%%%%%%%%%%%%%%%%
