%%%%%%%%%%%%%%%%%%%%%
%  ~   ~   ~   ~    %
%   ~   ~   ~   ~   %
% ~   ~   ~   ~   ~ %
%   ~   ~   ~   ~   %
%   ~ ~   ~   ~ ~   %
%     ~   ~   ~     %
%         R         %
%   ~   ~   ~   ~   %
% ~   ~   ~   ~   ~ %
% ~   ~   ~   ~   ~ %
%S   ~   ~   ~   ~  %
%%%%%%%%%%%%%%%%%%%%%
